34 64
1111111111111111111111111111111111111111111111111111111111111111
1000000001000000000000100000000101000000001000000000000100000001
1000000001000000000000100000000101000000001000000000000100000001
1000000001000000000000100000000101000000001000000000000100000001
1000000000000000001100100000000101000000001000000000000100000001
1000000001000000001100000000000101000000001000000000000100000001
1000000001001100000000100000000101000000001000000000000100000001
1000000001001100000000100000000101000000001000000000000100000001
1000000001000000001100100000000101000000001000000000000100000001
1000000001000000001100100000000101000000001000000000000100000001
1000000001001100000000100000000101000000001000000000000100000001
1000000000001100000000100000000101000000001000000000000100000001
1000000000000000001100100000000101000000001000000000000100000001
1000000001000000001100100000000101000000001000000000000100000001
1000000001000000000000100000000101000000001000000000000100000001
1000000001000000000000100000000101000000001000000000000100000001
1111111111111111111111111111111111111111111111111111111111111111
1111111111111111111111111111111111111111111111111111111111111111
1000000001000000000000100000000001000000001000000000000100000001
1000000001000000000000100000000001000000001000000000000100000001
1000000001000000000000100000000001000000001000000000000100000001
1000000000000000001100100000000101000000001000000000000100000001
1000000001000000001100000000000101000000001000000000000100000001
1000000001001100000000100000000101000000001000000000000100000001
1000000001001100000000100000000101000000001000000000000100000001
1000000001000000001100100000000101000000001000000000000100000001
1000000001000000001100100000000101000000001000000000000100000001
1000000001001100000000100000000101000000001000000000000100000001
1000000000001100000000100000000101000000001000000000000100000001
1000000000000000001100100000000101000000001000000000000100000001
1000000001000000001100100000000101000000001000000000000100000001
1000000001000000000000100000000101000000001000000000000100000001
1000000001000000000000100000000101000000001000000000000100000001
1111111111111111111111111111111111111111111111111111111111111111