17 32
11111111111111111111111111111111
10000000010000000000001000000001
10000000010011000000001000000001
10000000000011000000001000000001
10000000000000000011001000000001
10000000010000000011000000000001
10000000010011000000001000000001
10000000010011000000001000000001
10000000010000000011001000000001
10000000010000000011001000000001
10000000010011000000001000000001
10000000000011000000001000000001
10000000000000000011001000000001
10000000010000000011001000000001
10000000010000000000001000000001
10000000010000000000001000000001
11111111111111111111111111111111